g g S g g g g g g g
g g p g g g g g g g
g g p g g p p p g g
g g p g g p g p g g
g g p g g p g p g g
g g p p p p g p g g
g g g g g g g p g g
g g g g g g g p g g
g g g g g g g p g g
g g g g g g g E g g
