g g S g g g g g g g
g g p g g g g g g g
g g p g g g g g g g
g g p g g g g g g g
g g p g g g g g g g
g g p p p p p p p E
g g g g g g g g g g
g g g g g g g g g g
g g g g g g g g g g
g g g g g g g g g g
