g g p p p p p p p S
g g p g g g g g g g
g g p g g g g g g g
g g p g g g g g g g
g g p g g g g g g g
g g p g g g g g g g
g g p g g g g g g g
g g p g g g g g g g
g g p g g g g g g g
g g p p p p p p p E
