g g g g g g g g g g
g g g g g g g g g g
g g p p p p p p p E
g g p g g g g g g g
g g p g g g g g g g
g g p p p p g g g g
g g g g g p g g g g
g g g g g p g g g g
g g g g g p g g g g
g g g g g S g g g g
